铃木	すずき
佐藤	さとう
田中	たなか
小林	こばやし
高桥	たかはし
渡辺	わたなべ
加藤	かとう
斉藤	さいとう
伊藤	いとう
中村	なかむら
山本	やまもと
山田	やまだ
山口	やまぐち
佐々木	ささき
■桥	たかはし
石井	いしい
井上	いのうえ
吉田	よしだ
木村	きむら
松本	まつもと
清水	しみず
金子	かねこ
石川	いしかわ
阿部	あべ
青木	あおき
池田	いけだ
远藤	えんどう
森	もり
林	はやし
长谷川	はせがわ
小川	おがわ
山崎	やまざき
桥本	はしもと
后藤	ごとう
内田	うちだ
中岛	なかじま
近藤	こんどう
小野	おの
和田	わだ
山下	やました
原	はら
藤田	ふじた
杉山	すぎやま
三浦	みうら
小岛	こじま
太田	おおた
冈田	おかだ
中山	なかやま
前田	まえだ
村上	むらかみ
安藤	あんどう
原田	はらだ
横山	よこやま
石田	いしだ
坂本	さかもと
田村	たむら
福田	ふくだ
市川	いちかわ
饭田	いいだ
竹内	たけうち
工藤	くどう
小山	こやま
冈本	おかもと
大冢	おおつか
中野	なかの
今井	いまい
千叶	ちば
小泉	こいずみ
松田	まつだ
新井	あらい
佐野	さの
菊地	きくち
藤井	ふじい
岩崎	いわさき
中川	なかがわ
柴田	しばた
西村	にしむら
丸山	まるやま
荒井	あらい
村田	むらた
森田	もりた
酒井	さかい
关	せき
土屋	つちや
秋山	あきやま
大野	おおの
菊池	きくち
平野	ひらの
増田	ますだ
五十岚	いがらし
野口	のぐち
北村	きたむら
武田	たけだ
宫崎	みやざき
■田	よしだ
菅原	すがわら
小松	こまつ
桜井	さくらい
内藤	ないとう
久保田	くぼた
藤原	ふじわら
星野	ほしの
川口	かわぐち
杉本	すぎもと
上野	うえの
望月	もちづき
田辺	たなべ
栗原	くりはら
渋谷	しぶや
小池	こいけ
松井	まつい
安田	やすだ
宫本	みやもと
野村	のむら
大久保	おおくぼ
斎藤	さいとう
萩原	はぎわら
关口	せきぐち
伊东	いとう
须藤	すどう
岛田	しまだ
饭岛	いいじま
上田	うえだ
永井	ながい
岩田	いわた
福岛	ふくしま
本间	ほんま
久保	くぼ
木下	きのした
小沢	おざわ
本田	ほんだ
田口	たぐち
古川	ふるかわ
榎本	えのもと
大谷	おおたに
石渡	いしわた
西山	にしやま
樋口	ひぐち
石原	いしはら
早川	はやかわ
熊谷	くまがい
服部	はつとり
平井	ひらい
成田	なりた
马场	ばば
松尾	まつお
斋藤	さいとう
渡部	わたなべ
岩本	いわもと
川岛	かわしま
平田	ひらた
白井	しらい
高木	たかぎ
小泽	おざわ
内山	うちやま
水野	みずの
藤本	ふじもと
八木	やぎ
根本	ねもと
川村	かわむら
大桥	おおはし
佐久间	さくま
山内	やまうち
高野	たかの
天野	あまの
志村	しむら
川崎	かわさき
关根	せきね
河野	こうの
武藤	むとう
谷口	たにぐち
落合	おちあい
浅野	あさの
松下	まつした
宫田	みやた
川上	かわかみ
上原	うえはら
横田	よこた
大森	おおもり
瀬戸	せと
石冢	いしづか
山中	やまなか
若林	わかばやし
大岛	おおしま
荒木	あらき
広瀬	ひろせ
菅野	かんの
矢野	やの
大川	おおかわ
吉川	よしかわ
饭冢	いいづか
相原	あいはら
田代	たしろ
角田	つのだ
小野寺	おのでら
岸	きし
松冈	まつおか
浜田	はまだ
金井	かない
筱原	しのはら
村山	むらやま
本多	ほんだ
长岛	ながしま
西川	にしかわ
松村	まつむら
大石	おおいし
松浦	まつうら
三桥	みつはし
石桥	いしばし
永田	ながた
野田	のだ
吉野	よしの
柏木	かしわぎ
高田	たかだ
大木	おおき
镰田	かまた
尾崎	おざき
大山	おおやま
黒田	くろだ
堀	ほり
平山	ひらやま
辻	つじ
西田	にしだ
星	ほし
富田	とみた
吉村	よしむら
多田	ただ
小仓	おぐら
及川	おいかわ
牧野	まきの
臼井	うすい
稲叶	いなば
冈部	おかべ
■木	たかぎ
青山	あおやま
小宫	こみや
松原	まつばら
田岛	たじま
小笠原	おがさわら
片山	かたやま
宫下	みやした
笠原	かさはら
今野	こんの
渡边	わたなべ
堀内	ほりうち
冈村	おかむら
米山	よねやま
大西	おおにし
松永	まつなが
大竹	おおたけ
吉冈	よしおか
白石	しらいし
须田	すだ
今村	いまむら
小田	おだ
冈崎	おかざき
畠山	はたけやま
大贯	おおぬき
中西	なかにし
新仓	にいくら
町田	まちだ
足立	あだち
山岸	やまぎし
中田	なかだ
石黒	いしぐろ
大沢	おおさわ
长田	おさだ
荒川	あらかわ
武井	たけい
渡部	わたべ
三上	みかみ
村松	むらまつ
奥山	おくやま
坂井	さかい
冈	おか
根岸	ねぎし
秋元	あきもと
宫川	みやがわ
寺田	てらだ
片冈	かたおか
福井	ふくい
安部	あべ
児玉	こだま
渡邉	わたなべ
古谷	ふるや
山■	やまざき
相沢	あいざわ
神田	かんだ
杉浦	すぎうら
黒川	くろかわ
河合	かわい
杉田	すぎた
竹田	たけだ
中嶋	なかじま
沼田	ぬまた
津田	つだ
滝沢	たきざわ
松崎	まつざき
青柳	あおやぎ
矢岛	やじま
庄司	しようじ
江口	えぐち
守屋	もりや
森山	もりやま
荻野	おぎの
坂田	さかた
大场	おおば
古屋	ふるや
■野	たかの
小西	こにし
筱崎	しのざき
堀江	ほりえ
安达	あだち
浅井	あさい
北川	きたがわ
古贺	こが
中沢	なかざわ
森本	もりもと
栗田	くりた
野崎	のざき
土田	つちだ
神谷	かみや
三宅	みやけ
平本	ひらもと
冢本	つかもと
戸田	とだ
■田	たかだ
稲垣	いながき
高山	たかやま
豊田	とよだ
堤	つつみ
露木	つゆき
大泽	おおさわ
细谷	ほそや
大内	おおうち
冢田	つかだ
小嶋	こじま
大津	おおつ
泽田	さわだ
菅野	すがの
奥村	おくむら
关野	せきの
河原	かわはら
坂口	さかぐち
细川	ほそかわ
泉	いずみ
南	みなみ
森川	もりかわ
横沟	よこみぞ
大村	おおむら
樱井	さくらい
亀井	かめい
西	にし
二宫	にのみや
岩井	いわい
小菅	こすげ
■川	よしかわ
矢部	やべ
水谷	みずたに
吉原	よしはら
洼田	くぼた
冈野	おかの
野中	のなか
谷	たに
下田	しもだ
奥田	おくだ
中尾	なかお
大矢	おおや
金田	かねだ
手冢	てづか
河村	かわむら
植田	うえだ
山川	やまかわ
梅田	うめだ
松山	まつやま
村井	むらい
中里	なかざと
中原	なかはら
柳沢	やなぎさわ
中泽	なかざわ
中田	なかた
安西	あんざい
宫内	みやうち
井出	いで
森下	もりした
金沢	かなざわ
松野	まつの
福本	ふくもと
柳川	やながわ
沢田	さわだ
黒沢	くろさわ
细野	ほその
相马	そうま
小室	こむろ
永野	ながの
河野	かわの
东	あずま
杉崎	すぎざき
石山	いしやま
长尾	ながお
曽根	そね
保坂	ほさか
川田	かわだ
新田	につた
松岛	まつしま
土井	どい
上村	かみむら
前川	まえかわ
桑原	くわはら
平川	ひらかわ
二见	ふたみ
并木	なみき
西野	にしの
筱田	しのだ
曽我	そが
植木	うえき
川端	かわばた
岛村	しまむら
徳永	とくなが
奈良	なら
相泽	あいざわ
宫原	みやはら
冨田	とみた
三好	みよし
仓田	くらた
平林	ひらばやし
芳贺	はが
菅沼	すがぬま
甲斐	かい
长冈	ながおか
山村	やまむら
吉沢	よしざわ
朝仓	あさくら
高梨	たかなし
藤沢	ふじさわ
嶋田	しまだ
福冈	ふくおか
中井	なかい
矶部	いそべ
长野	ながの
柳田	やなぎだ
■山	たかやま
相川	あいかわ
片桐	かたぎり
井口	いぐち
岩瀬	いわせ
宫沢	みやざわ
小原	おばら
水岛	みずしま
北原	きたはら
皆川	みながわ
长沢	ながさわ
大槻	おおつき
藤野	ふじの
大井	おおい
榊原	さかきばら
池上	いけがみ
持田	もちだ
佐伯	さえき
广瀬	ひろせ
大原	おおはら
三木	みき
宇野	うの
大沼	おおぬま
西尾	にしお
岸本	きしもと
早坂	はやさか
茂木	もぎ
植松	うえまつ
堀口	ほりぐち
黒木	くろき
内海	うつみ
熊沢	くまざわ
広田	ひろた
大友	おおとも
小出	こいで
桑原	くわばら
出口	でぐち
山根	やまね
北岛	きたじま
下山	しもやま
雨宫	あめみや
进藤	しんどう
小俣	おまた
笠井	かさい
宇佐美	うさみ
竹村	たけむら
秋本	あきもと
重田	しげた
浅田	あさだ
川原	かわはら
矶崎	いそざき
石崎	いしざき
片野	かたの
诸星	もろほし
古田	ふるた
森谷	もりや
志贺	しが
富永	とみなが
野沢	のざわ
长瀬	ながせ
神保	じんぼ
鹤田	つるた
福原	ふくはら
小坂	こさか
藤村	ふじむら
川瀬	かわせ
川井	かわい
栗山	くりやま
岛崎	しまざき
大平	おおひら
三井	みつい
梅沢	うめざわ
下村	しもむら
内野	うちの
浅见	あさみ
饭野	いいの
大城	おおしろ
志田	しだ
小森	こもり
菅原	すがはら
今泉	いまいずみ
岩渕	いわぶち
沟口	みぞぐち
市村	いちむら
板垣	いたがき
西冈	にしおか
小杉	こすぎ
堀川	ほりかわ
三田	みた
胜又	かつまた
田畑	たばた
堀田	ほつた
岩沢	いわさわ
东	ひがし
竹下	たけした
宫城	みやぎ
依田	よだ
坪井	つぼい
三轮	みわ
田原	たはら
永岛	ながしま
草野	くさの
米田	よねだ
神山	かみやま
浜野	はまの
川野	かわの
宫川	みやかわ
三村	みむら
田所	たどころ
府川	ふかわ
吉泽	よしざわ
入江	いりえ
花田	はなだ
川本	かわもと
长泽	ながさわ
木内	きうち
金泽	かなざわ
滨田	はまだ
黒泽	くろさわ
绪方	おがた
葛西	かさい
奥津	おくつ
竹中	たけなか
齐藤	さいとう
藤川	ふじかわ
小柳	こやなぎ
亀山	かめやま
宫泽	みやざわ
诹访	すわ
风间	かざま
筒井	つつい
比嘉	ひが
柳	やなぎ
布施	ふせ
麻生	あそう
尾形	おがた
汤浅	ゆあさ
园田	そのだ
李	り
半田	はんだ
横井	よこい
藤冈	ふじおか
白川	しらかわ
杉原	すぎはら
松沢	まつざわ
矢口	やぐち
安斉	あんざい
松木	まつき
菅谷	すがや
石垣	いしがき
座间	ざま
若松	わかまつ
岩■	いわさき
向井	むかい
富樫	とがし
井田	いだ
汤川	ゆかわ
秋叶	あきば
野本	のもと
安井	やすい
长井	ながい
畑	はた
有马	ありま
福山	ふくやま
椎野	しいの
三枝	さえぐさ
大和田	おおわだ
阿久津	あくつ
长嶋	ながしま
梶原	かじわら
江藤	えとう
宍戸	ししど
广田	ひろた
竹本	たけもと
难波	なんば
亀田	かめだ
远山	とおやま
清野	せいの
高瀬	たかせ
细田	ほそだ
丹羽	にわ
小谷	こたに
有田	ありた
小峰	こみね
林田	はやしだ
关谷	せきや
成瀬	なるせ
岩下	いわした
滝口	たきぐち
中根	なかね
冢原	つかはら
堀越	ほりこし
石坂	いしざか
大庭	おおば
川名	かわな
佐竹	さたけ
鸟海	とりうみ
川辺	かわべ
岸田	きしだ
藤森	ふじもり
植村	うえむら
深沢	ふかざわ
藤巻	ふじまき
陈	ちん
河本	かわもと
浅川	あさかわ
菅	すが
神崎	かんざき
椎名	しいな
浅沼	あさぬま
上村	うえむら
鸟居	とりい
堀井	ほりい
添田	そえだ
岩间	いわま
中岛	なかしま
松川	まつかわ
平冢	ひらつか
瀬川	せがわ
秋田	あきた
目黒	めぐろ
千田	ちだ
福永	ふくなが
水上	みずかみ
加纳	かのう
佐川	さがわ
永山	ながやま
梅原	うめはら
宫岛	みやじま
宫■	みやざき
丹野	たんの
西原	にしはら
吉井	よしい
日野	ひの
富冈	とみおか
橘	たちばな
平冈	ひらおか
大田	おおた
木原	きはら
高井	たかい
吉本	よしもと
北野	きたの
■梨	たかなし
畑中	はたなか
须山	すやま
柳下	やぎした
中谷	なかたに
保田	やすだ
鹤冈	つるおか
本桥	もとはし
村冈	むらおか
西沢	にしざわ
徳田	とくだ
和泉	いずみ
板仓	いたくら
鹿岛	かしま
海老原	えびはら
村瀬	むらせ
立川	たちかわ
武内	たけうち
横尾	よこお
奥野	おくの
山冈	やまおか
角田	かくた
平松	ひらまつ
片仓	かたくら
长谷部	はせべ
大滝	おおたき
结城	ゆうき
大坪	おおつぼ
稲田	いなだ
长沼	ながぬま
宇田川	うだがわ
荻原	おぎはら
深谷	ふかや
高岛	たかしま
细井	ほそい
小堀	こぼり
小原	おはら
立花	たちばな
藤崎	ふじさき
桥口	はしぐち
门胁	かどわき
白鸟	しらとり
越智	おち
市原	いちはら
立石	たていし
原口	はらぐち
常盘	ときわ
长崎	ながさき
日高	ひだか
金城	きんじよう
小野田	おのだ
毛利	もうり
岩永	いわなが
岩泽	いわさわ
平沢	ひらさわ
江川	えがわ
松泽	まつざわ
伊沢	いざわ
五味	ごみ
小幡	おばた
相田	あいだ
玉井	たまい
宫坂	みやさか
仓持	くらもち
黒岩	くろいわ
野岛	のじま
波多野	はたの
清田	きよた
中丸	なかまる
牧	まき
蒲谷	かばや
菱沼	ひしぬま
大仓	おおくら
村越	むらこし
寺岛	てらしま
蛭田	ひるた
绵贯	わたぬき
江成	えなり
染谷	そめや
山崎	やまさき
东海林	しようじ
二瓶	にへい
香川	かがわ
板桥	いたばし
岩佐	いわさ
岛	しま
平	たいら
大熊	おおくま
小关	こせき
井手	いで
薄井	うすい
野上	のがみ
外山	とやま
椿	つばき
豊岛	とよしま
西本	にしもと
林	りん
三沢	みさわ
小宫山	こみやま
菅井	すがい
猪股	いのまた
赤坂	あかさか
猪俣	いのまた
前原	まえはら
大关	おおぜき
熊坂	くまさか
川合	かわい
上杉	うえすぎ
荻原	おぎわら
胁	わき
■野	よしの
大嶋	おおしま
加瀬	かせ
大江	おおえ
田川	たがわ
伏见	ふしみ
照井	てるい
杉村	すぎむら
三原	みはら
三岛	みしま
日下	くさか
门仓	かどくら
秦	はた
川嶋	かわしま
今	こん
高松	たかまつ
塩田	しおだ
滝本	たきもと
三谷	みたに
坂下	さかした
水口	みずぐち
梶	かじ
山室	やまむろ
影山	かげやま
绀野	こんの
南云	なぐも
西岛	にしじま
芹沢	せりざわ
川畑	かわばた
张	ちよう
正木	まさき
有贺	ありが
末永	すえなが
栗林	くりばやし
浦田	うらた
平贺	ひらが
绫部	あやべ
山形	やまがた
宫野	みやの
笹原	ささはら
关本	せきもと
小玉	こだま
西泽	にしざわ
藤泽	ふじさわ
长田	ながた
山上	やまがみ
深沢	ふかさわ
织田	おだ
氏家	うじいえ
梅泽	うめざわ
柳原	やなぎはら
村木	むらき
真壁	まかべ
吉永	よしなが
大崎	おおさき
矢沢	やざわ
橘川	きつかわ
熊泽	くまざわ
高村	たかむら
高柳	たかやなぎ
仓本	くらもと
须藤	すとう
柳泽	やなぎさわ
川■	かわさき
胜俣	かつまた
春日	かすが
金	きん
北见	きたみ
小清水	こしみず
柴山	しばやま
藤木	ふじき
碓井	うすい
江原	えはら
八巻	やまき
神戸	かんべ
野泽	のざわ
池谷	いけや
金山	かなやま
戸冢	とつか
上条	かみじよう
金森	かなもり
真田	さなだ
中林	なかばやし
益田	ますだ
矶野	いその
本山	もとやま
箕轮	みのわ
金	きむ
名取	なとり
岩野	いわの
福地	ふくち
松桥	まつはし
森冈	もりおか
熊仓	くまくら
那须	なす
■岛	たかしま
岩城	いわき
増山	ますやま
石野	いしの
矢崎	やざき
加山	かやま
坂元	さかもと
野原	のはら
三泽	みさわ
间宫	まみや
松元	まつもと
■井	たかい
中本	なかもと
小椋	おぐら
■村	よしむら
绿川	みどりかわ
大越	おおこし
大河原	おおかわら
谷川	たにかわ
■瀬	たかせ
深瀬	ふかせ
寺尾	てらお
日比野	ひびの
山城	やましろ
小山	おやま
杉野	すぎの
王	おう
百瀬	ももせ
下川	しもかわ
稲村	いなむら
室井	むろい
野吕	のろ
北山	きたやま
森井	もりい
柿沼	かきぬま
平尾	ひらお
古泽	ふるさわ
米沢	よねざわ
须贺	すが
仲村	なかむら
古沢	ふるさわ
日下部	くさかべ
平泽	ひらさわ
深田	ふかだ
尾上	おのうえ
河内	かわうち
会田	あいだ
青野	あおの
玉木	たまき
米仓	よねくら
城所	きどころ
飞田	とびた
村野	むらの
北沢	きたざわ
木田	きだ
前岛	まえじま
鸭志田	かもしだ
古木	ふるき
矢吹	やぶき
石丸	いしまる
菊田	きくた
本郷	ほんごう
明石	あかし
小山内	おさない
久米	くめ
金谷	かなや
牧田	まきた
相良	さがら
关戸	せきど
田边	たなべ
広川	ひろかわ
笠间	かさま
叶山	はやま
恩田	おんだ
横川	よこかわ
桐生	きりゆう
桜田	さくらだ
瀬尾	せお
柿崎	かきざき
水越	みずこし
浦野	うらの
长冢	ながつか
大畑	おおはた
土桥	どばし
岩村	いわむら
桐山	きりやま
福士	ふくし
矶贝	いそがい
城田	しろた
河田	かわだ
胜田	かつた
北条	ほうじよう
凑	みなと
粕谷	かすや
小山田	おやまだ
饭村	いいむら
谷本	たにもと
桥爪	はしづめ
羽鸟	はとり
梶山	かじやま
木岛	きじま
草柳	くさやなぎ
増井	ますい
狩野	かのう
木戸	きど
富沢	とみざわ
塩沢	しおざわ
保科	ほしな
丸田	まるた
柴崎	しばざき
饭山	いいやま
富山	とみやま
内村	うちむら
汤山	ゆやま
藤岛	ふじしま
山野	やまの
熊田	くまだ
岛津	しまづ
永瀬	ながせ
黒崎	くろさき
■冈	よしおか
伊泽	いざわ
漆原	うるしばら
福嶋	ふくしま
塩川	しおかわ
深井	ふかい
藤江	ふじえ
花井	はない
仓桥	くらはし
三留	みとめ
早野	はやの
斉木	さいき
高崎	たかさき
长坂	ながさか
山元	やまもと
小久保	こくぼ
比留川	ひるかわ
夏目	なつめ
深泽	ふかざわ
海野	うみの
小畑	おばた
榊	さかき
田上	たがみ
石冢	いしずか
田丸	たまる
藤平	ふじひら
草间	くさま
浜口	はまぐち
新藤	しんどう
田沢	たざわ
小松原	こまつばら
小暮	こぐれ
人见	ひとみ
石冈	いしおか
笹川	ささがわ
木本	きもと
郡司	ぐんじ
石仓	いしくら
北田	きただ
川越	かわごえ
塩谷	しおや
川田	かわた
小野沢	おのざわ
北泽	きたざわ
竹原	たけはら
斉田	さいた
澁谷	しぶや
鹤见	つるみ
平间	ひらま
生田	いくた
宇都宫	うつのみや
笹本	ささもと
河西	かさい
楠	くすのき
坂上	さかがみ
须永	すなが
仲田	なかだ
加贺谷	かがや
大泉	おおいずみ
小沼	おぬま
高原	たかはら
新堀	しんぼり
矶田	いそだ
境	さかい
冈岛	おかじま
神尾	かみお
寺本	てらもと
赤松	あかまつ
平良	たいら
久保寺	くぼでら
今田	いまだ
武	たけ
汤本	ゆもと
土居	どい
矶	いそ
真锅	まなべ
古山	ふるやま
大浦	おおうら
大坂	おおさか
二阶堂	にかいどう
西胁	にしわき
押田	おしだ
小田切	おだぎり
川又	かわまた
野地	のじ
猪狩	いがり
■村	たかむら
田泽	たざわ
田渕	たぶち
饭冢	いいずか
镰田	かまだ
田崎	たざき
大高	おおたか
神	じん
小栗	おぐり
长谷	はせ
■原	よしはら
水田	みずた
田嶋	たじま
田端	たばた
宫胁	みやわき
野尻	のじり
末吉	すえよし
大林	おおばやし
■松	たかまつ
小原	こはら
矢泽	やざわ
若月	わかつき
嘉山	かやま
坂野	さかの
玉川	たまがわ
若山	わかやま
井沢	いざわ
高冈	たかおか
直井	なおい
花冈	はなおか
谷川	たにがわ
平原	ひらはら
本村	もとむら
加贺	かが
芹泽	せりざわ
塙	はなわ
石沢	いしざわ
室伏	むろふし
嶋村	しまむら
川久保	かわくぼ
大和	やまと
饭沼	いいぬま
鸣海	なるみ
浅冈	あさおか
石本	いしもと
深野	ふかの
滝田	たきた
冨永	とみなが
八田	はつた
船木	ふなき
仲野	なかの
大宫	おおみや
都筑	つづき
土方	ひじかた
渥美	あつみ
胜山	かつやま
土谷	つちや
冈山	おかやま
越川	こしかわ
长山	ながやま
赤池	あかいけ
岛袋	しまぶくろ
尾■	おざき
城戸	きど
一ノ瀬	いちのせ
品川	しながわ
古桥	ふるはし
深泽	ふかさわ
小平	こだいら
佐山	さやま
寺内	てらうち
须贝	すがい
井原	いはら
梅本	うめもと
軽部	かるべ
宗像	むなかた
辻村	つじむら
奥	おく
笹野	ささの
伴	ばん
小熊	おぐま
石渡	いしわたり
伊达	だて
川添	かわぞえ
阪本	さかもと
伊势	いせ
品田	しなだ
石村	いしむら
竹山	たけやま
金野	こんの
高杉	たかすぎ
星川	ほしかわ
矢田	やだ
桑田	くわた
小柴	こしば
铃野	すずの
矢作	やはぎ
长浜	ながはま
门马	もんま
柳沼	やぎぬま
山浦	やまうら
池内	いけうち
金丸	かなまる
稲毛	いなげ
内海	うちうみ
中込	なかごめ
深川	ふかがわ
三瓶	さんぺい
井村	いむら
竹井	たけい
纲岛	つなしま
日■	ひだか
泽	さわ
寺沢	てらさわ
干	いぬい
八木下	やぎした
寺井	てらい
春山	はるやま
井泽	いざわ
羽田	はだ
佐原	さはら
松林	まつばやし
梅津	うめづ
浜	はま
黒沼	くろぬま
滝	たき
筱冢	しのづか
间瀬	ませ
矢嶋	やじま
池谷	いけたに
坂间	さかま
南部	なんぶ
关山	せきやま
北	きた
小寺	こでら
田尻	たじり
対马	つしま
长内	おさない
清野	きよの
小沼	こぬま
砂川	すながわ
前野	まえの
児岛	こじま
筱■	しのざき
小野冢	おのづか
米泽	よねざわ
有村	ありむら
海老沢	えびさわ
清田	せいた
胁田	わきた
柳瀬	やなせ
西谷	にしたに
冢越	つかごし
安川	やすかわ
梅津	うめつ
时田	ときた
今西	いまにし
藤山	ふじやま
丸冈	まるおか
小竹	こたけ
山■	やまさき
冲	おき
梅村	うめむら
园部	そのべ
塩崎	しおざき
峰岸	みねぎし
三富	みとみ
萩野	はぎの
武山	たけやま
小黒	おぐろ
游佐	ゆさ
江田	えだ
赤间	あかま
船山	ふなやま
吉崎	よしざき
吉川	きつかわ
新保	しんぼ
井川	いかわ
福沢	ふくざわ
原岛	はらしま
川西	かわにし
赤羽	あかばね
茂木	もてぎ
増渕	ますぶち
赤木	あかぎ
中冢	なかつか
驹井	こまい
柴崎	しばさき
唐沢	からさわ
鲛岛	さめじま
守谷	もりや
元木	もとき
国井	くにい
小金井	こがねい
泽井	さわい
増子	ますこ
森永	もりなが
大冈	おおおか
冲田	おきた
小口	おぐち
大堀	おおほり
真野	まの
青岛	あおしま
加茂	かも
坪田	つぼた
石毛	いしげ
穂坂	ほさか
里见	さとみ
森野	もりの
田沼	たぬま
松坂	まつざか
久野	くの
武石	たけいし
八幡	やはた
小矶	こいそ
石泽	いしざわ
大须贺	おおすが
豊田	とよた
桜庭	さくらば
塩野	しおの
关田	せきた
冲山	おきやま
籾山	もみやま
柳井	やない
喜多	きた
塩田	しおた
坂巻	さかまき
芦川	あしかわ
关水	せきみず
狩野	かりの
森口	もりぐち
重松	しげまつ
高见	たかみ
辻本	つじもと
藤原	ふじはら
宫村	みやむら
持丸	もちまる
小冢	こづか
海野	うんの
西条	さいじよう
泷泽	たきざわ
安冈	やすおか
戸村	とむら
平石	ひらいし
河口	かわぐち
滝川	たきがわ
古市	ふるいち
大河内	おおこうち
田邉	たなべ
向山	むこうやま
高尾	たかお
平戸	ひらと
松■	まつざき
冈■	おかざき
白岩	しらいわ
宇田	うだ
野间	のま
宫嶋	みやじま
三川	みかわ
柴	しば
一柳	いちやなぎ
神林	かんばやし
成井	なるい
广川	ひろかわ
広沢	ひろさわ
池本	いけもと
梶原	かじはら
新山	にいやま
藤代	ふじしろ
柏原	かしわばら
津久井	つくい
石上	いしがみ
熊野	くまの
我妻	わがつま
赤冢	あかつか
芦沢	あしざわ
田山	たやま
谷村	たにむら
村川	むらかわ
河内	かわち
诸桥	もろはし
小田岛	おだじま
羽贺	はが
藤枝	ふじえだ
海老冢	えびづか
滝泽	たきざわ
安东	あんどう
井本	いもと
国分	こくぶ
森岛	もりしま
小松崎	こまつざき
岩见	いわみ
河上	かわかみ
五岛	ごとう
东条	とうじよう
楠本	くすもと
片平	かたひら
住吉	すみよし
汤沢	ゆざわ
国分	こくぶん
新村	にいむら
荒	あら
白木	しらき
兼子	かねこ
中谷	なかや
河井	かわい
平出	ひらいで
■沢	よしざわ
角井	つのい
藤仓	ふじくら
长友	ながとも
堀田	ほりた
副岛	そえじま
江崎	えざき
新谷	しんたに
赤井	あかい
岩谷	いわや
幸田	こうだ
长岭	ながみね
一戸	いちのへ
中	なか
香取	かとり
横内	よこうち
芦田	あしだ
梅木	うめき
栗本	くりもと
三堀	みつぼり
嶋崎	しまざき
玉田	たまだ
生方	うぶかた
稲川	いながわ
半沢	はんざわ
泽村	さわむら
竹之内	たけのうち
今川	いまがわ
镰仓	かまくら
中戸川	なかとがわ
小早川	こばやかわ
込山	こみやま
陶山	すやま
久松	ひさまつ
益子	ますこ
永松	ながまつ
二本木	にほんぎ
安原	やすはら
大屋	おおや
中津川	なかつがわ
仁科	にしな
见上	みかみ
山县	やまがた
黒须	くろす
赤石	あかいし
有川	ありかわ
久保寺	くぼてら
角	すみ
鸟羽	とば
村石	むらいし
浜本	はまもと
饭尾	いいお
桑野	くわの
高仓	たかくら
棚桥	たなはし
寺西	てらにし
徳江	とくえ
八岛	やしま
千田	せんだ
最上	もがみ
堺	さかい
安永	やすなが
神原	かんばら
北井	きたい
坂东	ばんどう
木川	きがわ
石绵	いしわた
浦	うら
大曽根	おおそね
千野	ちの
郑	てい
西井	にしい
岩冈	いわおか
黄	こう
矢后	やご
田上	たのうえ
大里	おおさと
牧山	まきやま
门间	もんま
生驹	いこま
键和田	かぎわだ
畑山	はたやま
兵藤	ひようどう
寺冈	てらおか
日向	ひなた
友野	ともの
峰尾	みねお
鹫尾	わしお
门田	かどた
小形	おがた
塩见	しおみ
浅叶	あさば
畠中	はたなか
折原	おりはら
桂	かつら
神野	じんの
佐瀬	させ
根津ネ	づ
福元	ふくもと
萩原	はぎはら
饭嶋	いいじま
引地	ひきち
串田	くしだ
冢越	つかこし
成川	なりかわ
松平	まつだいら
涌井	わくい
日比	ひび
安室	やすむろ
出川	でがわ
古瀬	ふるせ
若杉	わかすぎ
关川	せきかわ
名仓	なぐら
宫尾	みやお
山木	やまき
大迫	おおさこ
长仓	ながくら
谷田部	やたべ
牛岛	うしじま
大岩	おおいわ
北冈	きたおか
川内	かわうち
刘	りゆう
佃	つくだ
仲宗根	なかそね
野川	のがわ
八代	やしろ
井坂	いさか
益子	ましこ
森胁	もりわき
朝比奈	あさひな
谷内	たにうち
津村	つむら
别府	べつぷ
森崎	もりさき
汤田	ゆだ
岩堀	いわほり
诹访部	すわべ
米川	よねかわ
浜崎	はまざき
宫前	みやまえ
江头	えがしら
高嶋	たかしま
馆野	たての
山森	やまもり
赤川	あかがわ
宍仓	ししくら
岩切	いわきり
清原	きよはら
小村	こむら
知念	ちねん
富泽	とみざわ
船越	ふなこし
水村	みずむら
糸井	いとい
田宫	たみや
石岛	いしじま
芝田	しばた
若井	わかい
大■	おおたか
菊川	きくかわ
庄子	しようじ
滨野	はまの
船津	ふなつ
甘利	あまり
大八木	おおやぎ
寺崎	てらさき
宫地	みやち
山路	やまじ
■泽	よしざわ
梶田	かじた
川戸	かわと
西方	にしかた
江尻	えじり
沢井	さわい
水戸	みと
河崎	かわさき
小牧	こまき
市桥	いちはし
大贺	おおが
荘司	しようじ
能登	のと
青田	あおた
沢野	さわの
寺山	てらやま
冨冈	とみおか
赤堀	あかほり
石森	いしもり
臼田	うすだ
■嶋	たかしま
岩元	いわもと
鴫原	しぎはら
西口	にしぐち
早瀬	はやせ
北林	きたばやし
戸部	とべ
野■	のざき
柳田	やなぎた
永冈	ながおか
平岩	ひらいわ
岛野	しまの
竹林	たけばやし
柏崎	かしわざき
门松	かどまつ
织茂	おりも
高须	たかす
仲川	なかがわ
马渕	まぶち
矢内	やない
高田	たかた
的场	まとば
植野	うえの
河西	かわにし
鹿野	しかの
田崎	たさき
津岛	つしま
朝日	あさひ
塩泽	しおざわ
平岛	ひらしま
市野	いちの
下里	しもざと
春田	はるた
木暮	こぐれ
端山	はやま
柳下	やなぎした
柿沢	かきざわ
坂仓	さかくら
日吉	ひよし
甘粕	あまかす
幡野	はたの
岸野	きしの
新垣	あらかき
今福	いまふく
花上	はなうえ
岩仓	いわくら
杨	よう
黒瀬	くろせ
土桥	つちはし
大下	おおした
北嶋	きたじま
莳田	まきた
疋田	ひきた
稲本	いなもと
河田	かわた
猪瀬	いのせ
下地	しもじ
丹治	たんじ
三田村	みたむら
村中	むらなか
山梨	やまなし
伊丹	いたみ
高城	たかぎ
东郷	とうごう
松嶋	まつしま
菊地原	きくちはら
小峰	こみね
古郡	ふるごおり
宫地	みやじ
八重樫	やえがし
寺泽	てらさわ
畑野	はたの
卫藤	えとう
菅田	すがた
■冈	たかおか
井川	いがわ
岛本	しまもと
竹岛	たけしま
谷山	たにやま
玉城	たましろ
浜崎	はまさき
福住	ふくずみ
岛贯	しまぬき
小浜	こはま
高畑	たかはた
守田	もりた
池野	いけの
关沢	せきざわ
长	ちよう
手岛	てじま
米村	よねむら
草薙	くさなぎ
合田	ごうだ
三角	みすみ
水落	みずおち
由井	ゆい
吉见	よしみ
浅利	あさり
井关	いせき
船桥	ふなばし
浅仓	あさくら
矶村	いそむら
梶川	かじかわ
熊本	くまもと
笹尾	ささお
沢村	さわむら
白仓	しらくら
宫	みや
猿渡	さるわたり
尾岛	おじま
莲见	はすみ
肥后	ひご
村尾	むらお
泽口	さわぐち
城	じよう
岩桥	いわはし
木口	きぐち
鬼头	きとう
高久	たかく
峰	みね
森屋	もりや
鹈饲	うかい
田部井	たべい
永嶋	ながしま
三觜	みつはし
安倍	あべ
小口	こぐち
嶋	しま
仓岛	くらしま
志水	しみず
大杉	おおすぎ
菅	かん
宫永	みやなが
牛尾	うしお
岸川	きしかわ
塩原	しおばら
高冢	たかつか
鸟山	とりやま
羽田	はねだ
浜中	はまなか
松仓	まつくら
浦川	うらかわ
南条	なんじよう
村本	むらもと
柴原	しばはら
首藤	しゆとう
须崎	すざき
渕上	ふちがみ
小贯	おぬき
吉成	よしなり
有泉	ありいずみ
助川	すけがわ
秦野	はたの
山胁	やまわき
江上	えがみ
袴田	はかまだ
土岐	とき
新野	にいの
猪又	いのまた
宇山	うやま
鹰野	たかの
东山	ひがしやま
栉田	くしだ
中条	なかじよう
西森	にしもり
久野	ひさの
宫代	みやしろ
内川	うちかわ
小岩	こいわ
小针	こばり
藤谷	ふじたに
犬冢	いぬづか
大串	おおぐし
笹田	ささだ
逸见	へんみ
丸尾	まるお
芝	しば
布川	ふかわ
戸井田	といだ
浅场	あさば
奥原	おくはら
川俣	かわまた
笹木	ささき
金丸	かねまる
高津	たかつ
沼仓	ぬまくら
今野	いまの
瀬戸口	せとぐち
水本	みずもと
峰尾	みねお
高林	たかばやし
室田	むろた
小田桐	おだぎり
平木	ひらき
伊原	いはら
今关	いまぜき
仙波	せんば
柘植	つげ
入沢	いりさわ
小野瀬	おのせ
力石	ちからいし
鸟越	とりごえ
熊木	くまき
仙田	せんだ
石津	いしづ
上冈	かみおか
多贺	たが
中森	なかもり
妹尾	せのお
高沢	たかざわ
永冢	ながつか
深见	ふかみ
友田	ともだ
西崎	にしざき
能势	のせ
青沼	あおぬま
浦山	うらやま
虾名	えびな
坂上	さかうえ
谷田	たにだ
锅岛	なべしま
竹川	たけかわ
山谷	やまや
猪野	いの
牛山	うしやま
坂	さか
冈安	おかやす
角田	かくだ
桑山	くわやま
新川	しんかわ
吉武	よしたけ
若狭	わかさ
有山	ありやま
板谷	いたや
瀬谷	せや
照屋	てるや
土肥	どひ
田子	たご
本庄	ほんじよう
神部	かんべ
半泽	はんざわ
大隅	おおすみ
呉	ご
平沼	ひらぬま
堀之内	ほりのうち
前山	まえやま
新城	しんじよう
寺门	てらかど
土志田	どしだ
近江	おおみ
下野	しもの
代田	しろた
白坂	しらさか
手岛	てしま
戸川	とがわ
徳山	とくやま
富井	とみい
飞田	ひだ
丸茂	まるも
蓑岛	みのしま
望月	もちずき
譲原	ゆずりはら
泽野	さわの
真下	ましも
一瀬	いちのせ
荻田	おぎた
上山	かみやま
木曽	きそ
古宫	こみや
兵头	ひようどう
柿本	かきもと
狩野	かの
笹冈	ささおか
玉置	たまおき
穂积	ほづみ
小方	おがた
只野	ただの
一色	いつしき
臼居	うすい
舟山	ふなやま
若尾	わかお
赤尾	あかお
橘田	きつた
迫田	さこだ
高森	たかもり
早田	はやた
桐原	きりはら
井野	いの
砂田	すなだ
杉崎	すぎさき
■仓	たかくら
所	ところ
中冈	なかおか
両角	もろずみ
一条	いちじよう
久我	くが
寺岛	てらじま
桥诘	はしづめ
崎山	さきやま
深津	ふかつ
松谷	まつたに
峰岸	みねぎし
君岛	きみしま
寒河江	さがえ
首藤	しゆどう
杉■	すぎざき
本杉	もとすぎ
山之内	やまのうち
金本	かねもと
福泽	ふくざわ
相场	あいば
大渕	おおぶち
熊井	くまい
玉城	たまき
冨樫	とがし
広野	ひろの
入泽	いりさわ
大类	おおるい
关原	せきはら
■柳	たかやなぎ
田坂	たさか
中沟	なかみぞ
小高	こだか
松叶	まつば
山野井	やまのい
高部	たかべ
丹	たん
桧山	ひやま
加贺美	かがみ
荫山	かげやま
本城	ほんじよう
浅羽	あさば
桑名	くわな
■原	たかはら
広井	ひろい
和久井	わくい
亀冈	かめおか
君岛	きみじま
笹井	ささい
白浜	しらはま
宫里	みやざと
黒滝	くろたき
雑贺	さいか
稲见	いなみ
栗城	くりき
吉山	よしやま
鹿野	かの
■崎	たかさき
山际	やまぎわ
潮田	うしおだ
丸	まる
笈川	おいかわ
木野	きの
作田	さくた
新海	しんかい
戸冢	とづか
肥田	ひだ
盛	もり
八锹	やくわ
秋吉	あきよし
折田	おりた
柏	かしわ
柴野	しばの
杉森	すぎもり
宫腰	みやこし
野木	のぎ
宇贺神	うがじん
金城	かねしろ
中嶋	なかしま
安本	やすもと
■杉	たかすぎ
大垣	おおがき
黒坂	くろさか
泷本	たきもと
戸仓	とくら
中园	なかぞの
布川	ぬのかわ
姫野	ひめの
赤城	あかぎ
池永	いけなが
岩松	いわまつ
嵯峨	さが
矢萩	やはぎ
粟野	あわの
蛯名	えびな
苅部	かりべ
高谷	たかや
尾关	おぜき
加川	かがわ
竹沢	たけざわ
矢代	やしろ
石神	いしがみ
伊奈	いな
清家	せいけ
■久	たかく
生井	なまい
水沢	みずさわ
若菜	わかな
■尾	たかお
竹野	たけの
藤间	ふじま
山名	やまな
坂入	さかいり
霜岛	しもじま
坪内	つぼうち
锦织	にしきおり
辺见	へんみ
向山	むかいやま
山内	やまのうち
